{
	"title": "SokEvo",
	"author": "Lee J Haywood",
	"website": "http://leehaywood.org",
	"levels": [
		"#######\n#.@ # #\n#$* $ #\n#   $ #\n# ..  #\n#  *  #\n#######\n",
		"#######\n#.    #\n#$* # #\n#.  $*#\n# .$  #\n#@ *  #\n#######\n",
		"#######\n#     #\n#@$.# #\n#*$  .#\n# $$  #\n# . . #\n#######\n",
		"#######\n#   ###\n#  ** #\n#   $ #\n#  $..#\n###@  #\n#######\n",
		"#######\n#   # #\n# $*  #\n# . + #\n# *$$ #\n##  . #\n#######\n",
		"########\n#+  ## #\n# $$   #\n# *. . #\n# $ *$.#\n#  . $ #\n###  * #\n########\n",
		"########\n# *.  .#\n# $    #\n# *##$$#\n#   $.+#\n# **   #\n#      #\n########\n",
		"########\n# *   .#\n#  $ * #\n# .$ $ #\n#* *  *#\n#.# #  #\n#    @ #\n########\n",
		"########\n###.  .#\n# $    #\n# *##$$#\n#   $ +#\n# *. * #\n#      #\n########\n",
		"#######\n#  .  #\n# $*$$#\n# ..$.#\n#@* $ #\n##.   #\n#######\n",
		"########\n#  #  *#\n#  * * #\n# *$ $ #\n#  .#. #\n#   # *#\n## @   #\n########\n",
		"#######\n#  *  #\n#.  $.#\n#.$   #\n# $*$+#\n# *   #\n#######\n",
		"#######\n#     #\n#$* # #\n#.@ $.#\n# .$$$#\n#  .. #\n#######\n",
		"########\n#   *@ #\n## .. .#\n# *$$.$#\n#  $.$ #\n# $ *.##\n##   ###\n########\n",
		"#######\n#  $. #\n#@*$ $#\n#.* . #\n# $  .#\n###   #\n#######\n",
		"#######\n#  .$ #\n#. @* #\n# $   #\n#$**$.#\n#..$  #\n#######\n",
		"#######\n#   *.#\n#  $ $#\n#. $* #\n#$ *+*#\n# .   #\n#######\n",
		"########\n#+  ## #\n#      #\n# *.#. #\n# $ #$.#\n# $  $ #\n# #  * #\n########\n",
		"########\n#.  ## #\n#  $   #\n#*$ $. #\n# $.#..#\n#@$  $ #\n# #  *.#\n########\n",
		"#######\n# *   #\n# $  .#\n#.# * #\n#@.$$ #\n# $ . #\n#######\n",
		"#######\n#  ##.#\n# $$ $#\n#. .. #\n#$ *  #\n#@*   #\n#######\n",
		"#######\n#   . #\n# .@$$#\n# * * #\n# $  .#\n###.$ #\n#######\n",
		"#######\n##    #\n#..$ @#\n# $ **#\n#$*$  #\n#.  . #\n#######\n",
		"########\n##### .#\n#   $ *#\n#  $ + #\n##$$#*.#\n#  $ * #\n# . .  #\n########\n",
		"########\n#+  ## #\n#      #\n# *.$. #\n# $.#$.#\n# $  $ #\n# #  * #\n########\n",
		"########\n# *   .#\n#  *   #\n# . #$ #\n#   $. #\n#@* #$ #\n## $ . #\n########\n",
		"#######\n# @   #\n#$* **#\n#. #$ #\n# . $ #\n#  .  #\n#######\n",
		"########\n# ..@$.#\n#. $   #\n#  $ $ #\n#.# * ##\n# #$$# #\n#. $ . #\n########\n",
		"#######\n#.    #\n#.$$$ #\n#. * .#\n#@$$*$#\n#. $..#\n#######\n",
		"########\n### *  #\n#   $ @#\n#   #. #\n#*  $* #\n# * .* #\n##  *  #\n########\n",
		"########\n#. $   #\n#.$##$ #\n#$ $.  #\n# $#.$.#\n#.   # #\n###  @.#\n########\n",
		"########\n#  .## #\n# $   @#\n#  **$ #\n#*.. # #\n#  * $*#\n# *    #\n########\n",
		"#######\n#.$ + #\n#.$.$ #\n#$$ $.#\n#  *.$#\n#  .  #\n#######\n",
		"########\n#  .   #\n# $##$ #\n#*$   .#\n#  *$@ #\n##$. # #\n#  . . #\n########\n",
		"#######\n#   @ #\n#$* * #\n#. *$ #\n# . $##\n#  .  #\n#######\n",
		"########\n#. .$ .#\n# $  $$#\n#@ $## #\n# *$ $ #\n#.* .. #\n##  *. #\n########\n",
		"#######\n#   . #\n# $.$ #\n#*$$# #\n#  $ .#\n# + . #\n#######\n",
		"#######\n#   #@#\n#  $$ #\n# # $ #\n# . ..#\n# #   #\n#######\n",
		"########\n# .   .#\n#  $ * #\n# .$#$ #\n#*$*  *#\n#+ ##$ #\n#  .   #\n########\n",
		"########\n#     ##\n# .*.$##\n# * .  #\n#* . $##\n#.$$ $ #\n#@$  . #\n########\n",
		"########\n###   ##\n# + $$ #\n#. .$ *#\n# * $  #\n##.#$# #\n##   . #\n########\n",
		"########\n#   *@ #\n#. #$. #\n# *$ * #\n#$ . $ #\n# .$# *#\n#   $..#\n########\n",
		"########\n#   + ##\n#. #$$ #\n# $  $ #\n# .### #\n#* #   #\n# .    #\n########\n",
		"########\n# *.  .#\n# $ $. #\n# *##$*#\n#   $+ #\n#  #  $#\n# .    #\n########\n",
		"#######\n#   *.#\n# *$$ #\n#. @#*#\n# . $ #\n# $.  #\n#######\n",
		"########\n#+  ** #\n# $$   #\n# *. . #\n# $ #$.#\n# *. $ #\n# #  * #\n########\n",
		"########\n#    * #\n#.#$$#.#\n#   *@ #\n#$*. *$#\n#. .$$.#\n#    $.#\n########\n",
		"########\n##  ...#\n#.$$* .#\n##$.$$ #\n# *  $##\n#@  $*.#\n# $  *.#\n########\n",
		"########\n#@#  . #\n#.$$#. #\n#  $  *#\n# #$$. #\n#$ $  .#\n#    ..#\n########\n",
		"#######\n#.    #\n# $$$@#\n#. # .#\n# $$*.#\n# $ ..#\n#######\n",
		"#######\n#  ##.#\n# $$ $#\n#. .  #\n#$$*  #\n#@. .##\n#######\n",
		"########\n#  $. ##\n#* # $ #\n#.*.   #\n##.$##@#\n# $$ $ #\n#..$.  #\n########\n",
		"########\n#.+. .##\n# ** $ #\n#  # # #\n#$# .  #\n# $ $$ #\n#.  $  #\n########\n",
		"########\n# @.$ .#\n# $   ##\n#.*$#  #\n#$ $.$ #\n#.* . ##\n##  *  #\n########\n",
		"########\n#  #####\n#  .####\n# $$$  #\n#.$  $.#\n#$#  #.#\n#@. * .#\n########\n",
		"########\n# #    #\n#  .$  #\n#$$.#$##\n#..    #\n#.$# $##\n#   * +#\n########\n",
		"########\n#  . $ #\n# $ .  #\n#  $#$@#\n#*# * .#\n#   .$##\n# * .$.#\n########\n",
		"########\n# .    #\n#$$ @$ #\n#.$# $ #\n# $.#  #\n# .$ **#\n#. ..$.#\n########\n",
		"########\n##  @  #\n#.#$##.#\n#$  $  #\n# #.**$#\n#  *$ .#\n#.   $.#\n########\n",
		"########\n#   ## #\n# $ @  #\n# #$#..#\n# $ #..#\n# $  * #\n# #  * #\n########\n",
		"#######\n#.  $@#\n#$$ $$#\n#. .$.#\n#.$*$.#\n## . .#\n#######\n",
		"#######\n##. *@#\n#..$*$#\n# $   #\n#$ $*.#\n# .   #\n#######\n",
		"#######\n#.. * #\n#.#$$ #\n#$  $ #\n# .$*.#\n##. $@#\n#######\n",
		"########\n##    .#\n## $$*.#\n#. * $$#\n#* .#  #\n#@$$$ ##\n#. .* .#\n########\n",
		"########\n##     #\n##$ $$ #\n#... $*#\n# ### .#\n# $ $  #\n# .+*  #\n########\n",
		"  #######\n  # $  .#\n ## #$  #\n #  $ .##\n##*.. *##\n# $$## +#\n# #   * #\n#    .$ #\n#########\n",
		"########\n# #    #\n# $@$  #\n# $#* $#\n#.$  *.#\n# $ #  #\n#.... ##\n########\n",
		"########\n#      #\n#$@*$$##\n# $ $ ##\n# $.#..#\n# ..*$.#\n#.     #\n########\n",
		"########\n#  #   #\n# .* $##\n#  $ $.#\n# *    #\n## ##$$#\n#.  . +#\n########\n",
		"#######\n###  .#\n# $$# #\n# @$. #\n#. $# #\n#   . #\n#######\n",
		"########\n##     #\n# $# $ #\n##.#$$ #\n#.+. #.#\n#** $* #\n#      #\n########\n",
		"########\n##  #  #\n# $  $ #\n## **  #\n# $    #\n# # #$$#\n#...@..#\n########\n",
		"########\n#     ##\n#.#.* .#\n# $$$  #\n#*. $* #\n#    #@#\n########\n",
		"#######\n#.* . #\n#.$ #.#\n# $   #\n#$* $$#\n#+$ . #\n#######\n",
		"########\n# #  +.#\n#.  *$ #\n# #$ ###\n# $ $$ #\n# ..*  #\n##     #\n########\n",
		"########\n#  . . #\n##$$$$ #\n## . # #\n#.  .# #\n#.$$*$ #\n# $.  +#\n########\n",
		"########\n#     ##\n#@$$ $##\n#   $ ##\n# *## .#\n# ..*$.#\n#.#    #\n########\n",
		"########\n#  +  .#\n# ##$$ #\n#    $##\n##$. $.#\n#  .#$##\n## .   #\n########\n",
		"########\n# . $ ##\n## $.$ #\n#...# .#\n# #$ $ #\n# $ #.$#\n# @    #\n########\n",
		"########\n## * .##\n#   .$ #\n#.# $  #\n#. *$# #\n# $#   #\n#  ##@##\n########\n",
		"########\n#...   #\n# #.## #\n# #    #\n# $  *$#\n## #$..#\n# $ $$ #\n# @ $ .#\n########\n",
		"########\n#  ..# #\n##$$   #\n# @ $..#\n# #$*$ #\n#.* $. #\n# #    #\n########\n",
		"########\n# @* #.#\n# $$ $ #\n#  # #*#\n##  .  #\n#  $.# #\n##  * .#\n########\n",
		"########\n#  .$  #\n# *$$. #\n#    $##\n#*$. $.#\n#  .#$ #\n##@.. ##\n########\n",
		"########\n# #    #\n# @*.* #\n# #$$$ #\n#.  * .#\n#.#$$$ #\n#  . . #\n########\n",
		"########\n# $.  .#\n# .$.  #\n# # $#.#\n#@$* $ #\n#.$ #$##\n#.     #\n########\n",
		"#########\n##  $. .#\n#  ## #$#\n# $#. ..#\n#  @## .#\n#* $$   #\n#   # $ #\n###   # #\n#########\n",
		"########\n##  .  #\n# #$@$ #\n# $. *$#\n#  *.$ #\n# . #$.#\n# #.   #\n########\n",
		"########\n#. .$  #\n#.$$$* #\n#  * # #\n#*$. # #\n#. $*  #\n# $.+  #\n########\n",
		"########\n# # . .#\n# $ #  #\n#. $# $#\n# $@*. #\n# #$  .#\n#  $.###\n########\n",
		"########\n#   . .#\n#@$#$  #\n# .$ $ #\n# $ #  #\n##*$# ##\n##... ##\n########\n",
		"#######\n#    .#\n#@# $ #\n#*  $##\n#     #\n#$$##.#\n#. *. #\n#.  $ #\n#######\n",
		"########\n#    # #\n#.# $* #\n#$$ * @#\n#. .$.##\n#  #$.##\n##     #\n########\n",
		"########\n# $. . #\n#.$.$  #\n#   *.$#\n# $# $.#\n# $+$ .#\n########\n",
		"########\n##@ .. #\n# #$#. #\n#   ..*#\n##$$ $ #\n#  $ $ #\n#   # .#\n########\n",
		"########\n#@$. $.#\n#  $ $.#\n# $$ $ #\n#. $.#*#\n###$*. #\n# . . .#\n########\n",
		"########\n## ##  #\n# $@$$ #\n#.#    #\n#.#$## #\n#   $. #\n# *.  .#\n########\n",
		"########\n##   # #\n#  $$ .#\n# $@$###\n#.#$   #\n#.* ## #\n#.  .  #\n########\n",
		"########\n# $. ..#\n#.$.$$ #\n#  .$  #\n###  ###\n#..* $ #\n#$$*$  #\n#@*  .##\n########\n",
		"########\n# #@   #\n#. ** ##\n#. #   #\n# $$ #.#\n# $ ** #\n#  .$  #\n########\n",
		"########\n#.  . ##\n# #  $ #\n#$*$##@#\n#  $.# #\n#. # $ #\n##  .  #\n########\n",
		"########\n#  ..# #\n# $  $ #\n#*$#$  #\n# @$.*##\n# #.   #\n#  . ###\n########\n",
		"##########\n# .. $   #\n#$. . $  #\n#. ####* #\n#$$ $  $*#\n#+*    . #\n##########\n",
		"#######\n#+$  .#\n#*$*$ #\n# $  .#\n#.$*$ #\n#.  . #\n#######\n",
		"########\n#   .$ #\n#$@* #.#\n# **$  #\n#  $.$$#\n#.#. #.#\n# $   .#\n########\n",
		"########\n#@$.   #\n#$*$  .#\n#.$ *#.#\n#  $ $ #\n# #$..##\n#.. $  #\n########\n",
		"#######\n###.###\n# . ###\n#.$*$.#\n#..  .#\n#*#$$$#\n#  @$.#\n##$$  #\n#     #\n#######\n"
	]
}
